##############################
#A.*.*.*.*...#..............B#
#.#.#.#.#.#..#............#..#
#............#............#..#
#.........................#..#
#################..########.##
#............#............#..#
#.........................#..#
#............#............#..#
#C...........#............#.D#
##############################